+-+-+-+-+-+-+
      |     |
+-+-+ + + + +
|   | | | | |
+ + + +-+ + +
| | | |   | |
+ +-+ + +-+-+
|     | |   |
+ +-+-+ +-+ +
|       |   |
+-+-+ +-+ + +
|         | |
+-+-+-+-+-+-+