+--+--+--+--+--+
      |  |     |
+  +  +  +  +--+
|  |     |     |
+  +--+  +  +  +
|     |  |  |  |
+--+--+  +  +  +
|        |  |  |
+--+  +--+--+  +
|     |  |     |
+  +--+  +  +--+
|  |     |  |  |
+  +  +--+  +  +
|        |  |  |
+--+--+  +  +  +
|     |  |     |
+  +  +  +  +--+
|  |     |  |  |
+  +--+--+  +  +
|           |  |
+--+  +  +--+  +
|     |        |
+  +--+--+--+--+
|               
+--+--+--+--+--+