+-+-+-+-+-+-+-+-+-+-+
    |           |   |
+-+ + +-+-+-+ + + + +
|   | | |     | | | |
+ +-+ + + +-+-+ + +-+
|   | | | | |   |   |
+-+ + + + + + +-+-+ +
|   | |   | | |     |
+ +-+ +-+-+ + + +-+ +
|       | |   | |   |
+ +-+-+ + +-+-+ + +-+
| |   | |       | | |
+ +-+ + +-+-+-+-+ + +
|     |         | | |
+ +-+-+-+-+-+-+ + + +
|     |     |     | |
+-+-+ + + + + + +-+ +
|   | | | |   |   | |
+ + + + +-+-+-+-+-+-+
| |   |       |      
+-+-+-+-+-+-+-+-+-+-+